▮,▮,▮,▮,▮,▮,▮,▮,▮,▮,▮,▮,▮,▮,▮,▮,▮,▮,▮,▮,▮,▮,▮,▮,▮,▮,▮,▮,▮,
▮,▮,▮,▮,▮,▮,▮,▮,▮,▮,▮,▮,▮,▮,▮,▮,▮,▮,▮,▮,▮,▮,▮,▮,▮,▮,▮,▮,▮,
▮,▮,▮,▯,▯,▯,▯,▯,▯,▯,▯,▯,▯,▯,▯,▯,▯,▯,▯,▯,▯,▯,▯,▯,▯,▯,▮,▮,▮,
▮,▮,▯,▯,▯,▯,▯,▯,▯,▯,▯,▯,▯,▯,▯,▯,▯,▯,▯,▯,▯,▯,▯,▯,▯,▯,▯,▮,▮,
▮,▯,▯,▯,▯,▯,▯,▯,▯,▯,▯,▯,▯,▯,▯,▯,▯,▯,▯,▯,▯,▯,▯,▯,▯,▯,▯,▯,▮,
▮,▯,▯,▯,▯,▯,▯,▣,▯,▯,▯,▯,▯,▯,▯,▯,▯,▯,▯,▯,▯,▣,▯,▯,▯,▯,▯,▯,▮,
▮,▯,▯,▯,▯,▯,▮,▮,▮,▮,▯,▯,▯,▯,▯,▯,▯,▯,▯,▮,▮,▮,▮,▯,▯,▯,▯,▯,▮,
▮,▯,▯,▯,▯,▯,▯,▯,▯,▯,▯,▯,▯,▯,▣,▯,▯,▯,▯,▯,▯,▯,▯,▯,▯,▯,▯,▯,▮,
▮,▮,▯,▯,▯,▯,▯,▯,▯,▯,▯,▯,▮,▮,▮,▮,▮,▯,▯,▯,▯,▯,▯,▯,▯,▯,▯,▮,▮,
▮,▯,▯,▯,▯,▯,▯,▯,▯,▯,▯,▯,▯,▯,▯,▯,▯,▯,▯,▯,▯,▯,▯,▯,▯,▯,▯,▯,▮,
▮,▯,▯,▯,▣,▯,▯,▯,▯,▯,▣,▯,▯,▯,▯,▯,▯,▯,▣,▯,▯,▯,▯,▯,▣,▯,▯,▯,▮,
▮,▯,▯,▮,▮,▮,▯,▯,▯,▮,▮,▮,▮,▯,▯,▯,▮,▮,▮,▮,▯,▯,▯,▮,▮,▮,▯,▯,▮,
▮,▯,▯,▯,▯,▯,▯,▯,▯,▯,▯,▯,▯,▯,▯,▯,▯,▯,▯,▯,▯,▯,▯,▯,▯,▯,▯,▯,▮,
▮,▯,▯,▯,▯,▯,▯,▣,▯,▯,▯,▯,▯,▯,▯,▯,▯,▯,▯,▯,▯,▣,▯,▯,▯,▯,▯,▯,▮,
▮,▯,▯,▯,▮,▮,▮,▮,▮,▮,▯,▯,▯,▯,▯,▯,▯,▯,▯,▮,▮,▮,▮,▮,▮,▯,▯,▯,▮
▮,▯,▯,▯,▯,▯,▯,▯,▯,▯,▯,▯,▯,▯,▯,▯,▯,▯,▯,▯,▯,▯,▯,▯,▯,▯,▯,▯,▮,
▮,▯,▯,▯,▯,▯,▯,▯,▯,▯,▯,▯,▯,▯,▣,▯,▯,▯,▯,▯,▯,▯,▯,▯,▯,▯,▯,▯,▮,
▮,▮,▮,▮,▮,▮,▮,▮,▮,▮,▮,▮,▮,▮,▮,▮,▮,▮,▮,▮,▮,▮,▮,▮,▮,▮,▮,▮,▮,