▮,▮,▮,▮,▮,▮,▮,▮,▮,▮,▮,▮,▮,▮,▮,▮,▮,▮,▮,▮,▮,▮,▮,▮,▮,▮,▮
▮,▮,▮,▮,▮,▮,▮,▮,▮,▮,▮,▮,▮,▮,▮,▮,▮,▮,▮,▮,▮,▮,▮,▮,▮,▮,▮
▮,▮,▮,▯,▯,▯,▯,▯,▯,▯,▯,▯,▯,▯,▯,▯,▯,▯,▯,▯,▯,▯,▯,▯,▮,▮,▮
▮,▮,▯,▯,▯,▯,▯,▯,▯,▯,▯,▯,▯,▯,▯,▯,▯,▯,▯,▯,▯,▯,▯,▯,▯,▮,▮
▮,▯,▯,▯,▯,▯,▯,▯,▯,▯,▯,▯,▯,▯,▯,▯,▯,▯,▯,▯,▯,▯,▯,▯,▯,▯,▮
▮,▯,▯,▯,▯,▯,▯,▯,▯,▯,▯,▯,▯,▯,▯,▯,▯,▯,▯,▯,▯,▯,▯,▯,▯,▯,▮
▮,▯,▯,▯,▯,▯,▮,▮,▮,▮,▯,▯,▯,▯,▯,▯,▯,▮,▮,▮,▮,▯,▯,▯,▯,▯,▮
▮,▯,▯,▯,▯,▯,▯,▯,▯,▯,▯,▯,▯,▯,▯,▯,▯,▯,▯,▯,▯,▯,▯,▯,▯,▯,▮
▮,▮,▯,▯,▯,▯,▯,▯,▯,▯,▯,▮,▮,▮,▮,▮,▯,▯,▯,▯,▯,▯,▯,▯,▯,▮,▮
▮,▯,▯,▯,▯,▯,▯,▯,▯,▯,▯,▯,▯,▯,▯,▯,▯,▯,▯,▯,▯,▯,▯,▯,▯,▯,▮
▮,▯,▯,▯,▯,▯,▯,▯,▯,▯,▯,▯,▯,▯,▯,▯,▯,▯,▯,▯,▯,▯,▯,▯,▯,▯,▮
▮,▯,▯,▮,▮,▯,▯,▯,▮,▮,▮,▮,▯,▯,▯,▮,▮,▮,▯,▯,▯,▯,▯,▮,▮,▯,▮
▮,▯,▯,▯,▯,▯,▯,▯,▯,▯,▯,▯,▯,▯,▯,▯,▯,▯,▯,▯,▯,▯,▯,▯,▯,▯,▮
▮,▯,▯,▯,▯,▯,▯,▯,▯,▯,▯,▯,▯,▯,▯,▯,▯,▯,▯,▯,▯,▯,▯,▯,▯,▯,▮
▮,▯,▯,▯,▮,▮,▮,▮,▮,▮,▯,▯,▯,▯,▯,▯,▯,▮,▮,▮,▮,▮,▮,▯,▯,▯,▮
▮,▯,▯,▯,▯,▯,▯,▯,▯,▯,▯,▯,▯,▯,▯,▯,▯,▯,▯,▯,▯,▯,▯,▯,▯,▯,▮
▮,▯,▯,▯,▯,▯,▯,▯,▯,▯,▯,▯,▯,▯,▯,▯,▯,▯,▯,▯,▯,▯,▯,▯,▯,▯,▮
▮,▮,▮,▮,▮,▮,▮,▮,▮,▮,▮,▮,▮,▮,▮,▮,▮,▮,▮,▮,▮,▮,▮,▮,▮,▮,▮